111111111111111111111111111111111111111111111
100000000000000000000000000000000000000000001
1000P0C00000000000000000000000000000000000001
100000000000000000000000000000000000000000001
100000000000000000000000000000000000000000001
100000000000000000000000000000000000000000001
100000000000000000000000000000000000000000001
100000000000000N00000000000000000000000000001
10000000000000000000000000000000E000000000001
100000000000000000000000000000000000000000001
1000000000000000000000010000000000E0000000001
100000000000000000000001000000000000000000001
100000000000000000000001000000000000000000001
111111111111111111111111111111111111111111111
